           4 
###########.###
#.............#
#.............#
#..............6
#.............#
#.............#
#.............#
###############
           