###############
#.............#
#...#..........3
#.........#...#
#.............#
#......#......#
#.............#
###########.###
           1