             2
 ############.##
 #.............#
 #..............3
 #.............#
 #.............#
 #..............0
 #.............#
 ###############