  4          
##.############
#.........#...#
#.........#...#
#...#..........6
#...#.........#
#.........#...#
#.........#...#
###############
           