 ###############
2..............#
 #...#.........#
 #.........#...#
 #.............#
1.......#......#
 #.............#
 ###########.###
            4