 ###############
 #..........#..#
 #...#..........4
1.........#....#
 #.............#
 #...#.....#...#
 #.............#
 ###############
