 ###############
 #.............#
 #.............#
5..............#
 #.............#
 #.............#
 #.............#
 ###############
           