            3 
 ###########.###
 #.............#
 #.............#
 #.............#
 #.............#
0..............#
 #.............#
 ###########.###
            5