###############
#.............#
..............#
#.............#
#.............#
#..............
#.............#
########.######