###############
#.............#
#...#..........3
#.........#...#
#.............#
#......#......#
#.............#
###.###########
   1       