 ###############
 #..........#..#
 #.#........#...4
1..#...........#
 #.#........#..#
 #.#........#..#
 #..........#..#
 ###############
