###############
#..........#..#
#...#.........4
1........#....#
#.............#
#...#.....#...#
#.............#
###############
